{
    "characters":[],
    "world":[
        {
            "tileSet":"cobblestone",
            "tileMap":[
                "┌","─","─","─","─","─","─","─","─","─","─","┬","─","─","─","─","─","─","┐",   ,
                   ,"▒","▒","▒","▒","▒","▒","▒","▒","▒","▒","│","▒","▒","▒","▒","▒","▒","└","┐",
                "└","─","─","─","─","─","─","─","─","┐","▒","│","▒","▒","▒","▒","▒","▒","▒","│",
                   ,   ,   ,   ,   ,   ,   ,   ,   ,"│","▒","▒","▒","▒","▒","▒","▒","▒","▒","│",
                   ,   ,   ,   ,   ,   ,   ,   ,   ,"│","▒","│","▒","▒","▒","▒","▒","▒","┌","┘",
                   ,   ,   ,   ,   ,   ,   ,   ,   ,"│","▒","└","┬","─","─","─","─","─","┘"  ,   ,
                   ,   ,   ,   ,   ,   ,   ,   ,"┌","┘","▒","▒","└","┐",   ,   ,   ,   ,   ,   ,
                   ,   ,   ,   ,   ,   ,   ,   ,"│","▒","▒","▒","▒","│",   ,   ,   ,   ,   ,   ,
                   ,   ,   ,   ,   ,   ,   ,"┌","┘","▒","▒","▒","▒","└","┐",   ,   ,   ,   ,   ,
                   ,   ,   ,   ,   ,   ,   ,"│","▒","▒","▒","▒","▒","▒","└","─","─","─","─","┐",
                   ,   ,   ,   ,   ,   ,   ,"│","▒","▒","▒","▒","▒","▒","▒","▒","▒","▒","▒",   ,
                   ,   ,   ,   ,   ,   ,   ,"│","▒","▒","▒","▒","▒","▒","┌","─","─","─","─","┘",
                   ,   ,   ,   ,"┌","─","─","┘","▒","▒","▒","▒","▒","▒","│",   ,   ,   ,   ,   ,
                   ,   ,   ,   ,"│","▒","▒","▒","▒","▒","▒","▒","▒","▒","│",   ,   ,   ,   ,   ,
                "┌","─","─","─","┘","▒","▒","▒","▒","▒","▒","▒","▒","▒","│",   ,   ,   ,   ,   ,
                   ,"▒","▒","▒","▒","▒","▒","▒","┌","┐","▒","▒","┌","─","┘",   ,   ,   ,   ,   ,
                "└","─","─","─","─","┐","▒","▒","└","┘","▒","▒","│",   ,   ,   ,   ,   ,   ,   ,
                   ,   ,   ,   ,   ,"└","┐","▒","▒","▒","▒","▒","│",   ,   ,   ,   ,   ,   ,   ,
                   ,   ,   ,   ,   ,   ,"└","─","─","┐","▒","▒","│",   ,   ,   ,   ,   ,   ,   ,
                   ,   ,   ,   ,   ,   ,   ,   ,   ,"└",   ,   ,"┘",   ,   ,   ,   ,   ,   ,

            ]
        }
    ]
}
